#######E########E####################
# ### #   ###### #    #     #     # E
# ### #####      #  #    #     #    #
# ### # # ######## ##################
#            #       #    #   #   # #
#  # ##      #########  # # # # # # #
#  #         #   #   #  # # # # #   #
#  ######   ###  #  ### # # # # ### #
#  #    #               #   #   #   #
#  # ## ########   ## ###########   #
#    ##          ###                #
# ## #############  ###   ####   ## #
#  ### ##         #  #  #           #
#  #   ## ####     #    #      ###  #
#  # #### #  #     #    #####       #
#  #      #      ###           ##   #
#  #####           #   ##   #   #   #
#                                   #
##################^##################
